|||||||||||||||||||||||||||
|.........................|
|...E.....................|
|.........................|
|.........................|
||||..|||.................| 
|.......|.................|
|.......|.................|
||||||||||||||||...||||||||
|.........................|
|.........................|
|...|...|...|...|...|.....|
|.........................|
|.........................|
|.|.|.|.|.|.|.|.|.|.|.|.|.|
|.........................|
|.|.|.|.|.|.|.|.|.|.|.|.|.|
|.........................|
|.|.|.|.|.|.|.|.|.|.|.|.|.|
|.........................|
|.|.|.|.|.|.|.|.|.|.|.|.|.|
|.........................|
|||||||||||||||||||||||||||